#INDEX is temperature in Celcius. (example)
#INDEX,0dB_BFRF,6dB_BFRF,12dB_BFRF,18dB_BFRF
20,0x00,0x06,0x12,0x18
25,0x00,0x06,0x12,0x18
30,0x00,0x06,0x12,0x18
35,0x00,0x06,0x12,0x18
40,0x00,0x06,0x12,0x18
45,0x00,0x06,0x12,0x18
50,0x00,0x06,0x12,0x18
55,0x00,0x06,0x12,0x18
60,0x00,0x06,0x12,0x18
65,0x00,0x06,0x12,0x18

